5,5,5,5,5,5,5,5,5,5,5,5,5,5,5,5,	5,5,5,5,5,5,5,5,5,5,5,5,5,5,5,5,	5,5,5,5,5,5,5,5,5,5,5,5,5,5,5,5,
5,5,5,5,5,5,5,5,5,5,5,5,5,5,5,5,	5,5,5,5,5,5,5,5,5,5,5,5,5,5,5,5,	5,5,5,5,5,5,5,5,5,5,5,5,5,5,5,5,
5,5,5,5,5,5,5,5,5,5,5,5,5,5,5,5,	5,5,5,5,5,5,5,5,5,5,5,5,5,5,5,5,	5,5,5,5,5,5,5,5,5,5,5,5,5,5,5,5,
5,5,5,5,5,5,5,5,5,5,5,5,5,5,5,5,	5,5,5,5,5,5,5,5,5,5,5,5,5,5,5,5,	5,5,5,5,5,5,5,5,5,5,5,5,5,5,5,5,
5,5,5,5,5,5,5,5,5,5,5,5,5,5,5,5,	5,5,5,5,5,5,5,5,5,5,5,5,5,5,5,5,	5,5,5,5,5,5,5,5,5,5,5,5,5,5,5,5,
5,5,5,5,5,5,5,5,5,5,5,5,5,5,5,5,	5,5,5,5,5,5,5,5,5,5,5,5,5,5,5,5,	5,5,5,5,5,5,5,5,5,5,5,5,5,5,5,5,
5,5,5,5,5,5,5,5,5,5,5,5,5,5,5,5,	5,5,5,5,5,5,5,5,5,5,5,5,5,5,5,5,	5,5,5,5,5,5,5,5,5,5,5,5,5,5,5,5,
5,5,5,5,5,5,5,5,5,5,5,5,5,5,5,5,	5,5,5,5,5,5,5,5,5,5,5,5,5,5,5,5,	5,5,5,5,5,5,5,5,5,5,5,5,5,5,5,5,
5,5,5,5,5,5,5,5,5,5,5,5,5,5,5,5,	5,5,5,5,5,5,5,5,5,5,5,5,5,5,5,5,	5,5,5,5,5,5,5,5,5,5,5,5,5,5,5,5,
5,5,5,5,5,5,5,5,5,5,5,5,5,5,5,5,	5,5,5,5,5,5,5,5,5,5,5,5,5,5,5,5,	5,5,5,5,5,5,5,5,5,5,5,5,5,5,5,5,
5,5,5,5,5,5,5,5,5,5,5,5,5,5,5,5,	5,5,5,5,5,5,5,5,5,5,5,5,5,5,5,5,	5,5,5,5,5,5,5,5,5,5,5,5,5,5,5,5,
5,5,5,5,5,5,5,5,5,5,5,5,5,5,5,5,	5,5,5,5,5,5,5,5,5,5,5,5,5,5,5,5,	5,5,5,5,5,5,5,5,5,5,5,5,5,5,5,5,
5,5,5,5,5,5,5,5,5,5,5,5,5,5,5,5,	5,5,5,5,5,5,5,5,5,5,5,5,5,5,5,5,	5,5,5,5,5,5,5,5,5,5,5,5,5,5,5,5,
5,5,5,5,5,5,5,5,5,5,5,5,5,5,5,5,	5,5,5,5,5,5,5,5,5,5,5,5,5,5,5,5,	5,5,5,5,5,5,5,5,5,5,5,5,5,5,5,5,
5,5,5,5,5,5,5,5,5,5,5,5,5,5,5,5,	5,5,5,5,5,5,5,5,5,5,5,5,5,5,5,5,	5,5,5,5,5,5,5,5,5,5,5,5,5,5,5,5,
5,5,5,5,5,5,5,5,5,5,5,5,5,5,5,5,	5,5,5,5,5,5,5,5,5,5,5,5,5,5,5,5,	5,5,5,5,5,5,5,5,5,5,5,5,5,5,5,5,

5,5,5,5,5,5,5,5,5,5,5,5,5,5,5,5,	5,5,5,5,5,5,5,5,5,5,5,5,5,5,5,5,	5,5,5,5,5,5,5,5,5,5,5,5,5,5,5,5,
5,5,5,5,5,5,5,5,5,5,5,5,5,5,5,5,	5,5,5,5,5,5,5,5,5,5,5,5,5,5,5,5,	5,5,5,5,5,5,5,5,5,5,5,5,5,5,5,5,
5,5,5,5,5,5,5,5,5,5,5,5,5,5,5,5,	5,5,5,5,5,5,5,5,5,5,5,5,5,5,5,5,	5,5,5,5,5,5,5,5,5,5,5,5,5,5,5,5,
5,5,5,5,5,5,5,5,5,5,5,5,5,5,5,5,	5,5,5,5,5,5,5,5,5,5,5,5,5,5,5,5,	5,5,5,5,5,5,5,5,5,5,5,5,5,5,5,5,
5,5,5,5,5,5,5,5,5,5,5,5,5,5,5,5,	5,5,5,5,5,5,5,5,5,5,5,5,5,5,5,5,	5,5,5,5,5,5,5,5,5,5,5,5,5,5,5,5,
5,5,5,5,5,5,5,5,5,5,5,5,5,5,5,5,	5,5,5,5,5,5,5,5,5,5,5,5,5,5,5,5,	5,5,5,5,5,5,5,5,5,5,5,5,5,5,5,5,
5,5,5,5,5,5,5,5,5,5,5,5,5,5,5,5,	5,5,5,5,5,5,5,5,5,5,5,5,5,5,5,5,	5,5,5,5,5,5,5,5,5,5,5,5,5,5,5,5,
5,5,5,5,5,5,5,5,5,5,5,5,5,5,5,5,	5,5,5,5,5,5,5,5,5,5,5,5,5,5,5,5,	5,5,5,5,5,5,5,5,5,5,5,5,5,5,5,5,
5,5,5,5,5,5,5,5,5,5,5,5,5,5,5,5,	5,5,5,5,5,5,5,5,5,5,5,5,5,5,5,5,	5,5,5,5,5,5,5,5,5,5,5,5,5,5,5,5,
5,5,5,5,5,5,5,5,5,5,5,5,5,5,5,5,	5,5,5,5,5,5,5,5,5,5,5,5,5,5,5,5,	5,5,5,5,5,5,5,5,5,5,5,5,5,5,5,5,
5,5,5,5,5,5,5,5,5,5,5,5,5,5,5,5,	5,5,5,5,5,5,5,5,5,5,5,5,5,5,5,5,	5,5,5,5,5,5,5,5,5,5,5,5,5,5,5,5,
5,5,5,5,5,5,5,5,5,5,5,5,5,5,5,5,	5,5,5,5,5,5,5,5,5,5,5,5,5,5,5,5,	5,5,5,5,5,5,5,5,5,5,5,5,5,5,5,5,
5,5,5,5,5,5,5,5,5,5,5,5,5,5,5,5,	5,5,5,5,5,5,5,5,5,5,5,5,5,5,5,5,	5,5,5,5,5,5,5,5,5,5,5,5,5,5,5,5,
5,5,5,5,5,5,5,5,5,5,5,5,5,5,5,5,	5,5,5,5,5,5,5,5,5,5,5,5,5,5,5,5,	5,5,5,5,5,5,5,5,5,5,5,5,5,5,5,5,
5,5,5,5,5,5,5,5,5,5,5,5,5,5,5,5,	5,5,5,5,5,5,5,5,5,5,5,5,5,5,5,5,	5,5,5,5,5,5,5,5,5,5,5,5,5,5,5,5,
5,5,5,5,5,5,5,5,5,5,5,5,5,5,5,5,	5,5,5,5,5,5,5,5,5,5,5,5,5,5,5,5,	5,5,5,5,5,5,5,5,5,5,5,5,5,5,5,5,

0,0,0,0,0,0,0,0,0,0,0,0,0,0,0,0,	5,5,5,5,5,5,5,5,5,5,5,5,5,5,5,5,	5,5,5,5,5,5,5,5,5,5,5,5,5,5,5,5,
0,0,0,0,0,0,0,0,0,0,0,0,0,0,0,0,	5,5,5,5,5,5,5,5,5,5,5,5,5,5,5,5,	5,5,5,5,5,5,5,5,5,5,5,5,5,5,5,5,
0,0,0,0,0,0,0,0,0,0,0,0,0,0,0,0,	5,5,5,5,5,5,5,5,5,5,5,5,5,5,5,5,	5,5,5,5,5,5,5,5,5,5,5,5,5,5,5,5,
0,0,0,0,0,0,0,0,0,0,0,0,0,0,0,0,	5,5,5,5,5,5,5,5,5,5,5,5,5,5,5,5,	5,5,5,5,5,5,5,5,5,5,5,5,5,5,5,5,
0,0,0,0,0,0,0,0,0,0,0,0,0,0,0,0,	5,5,5,5,5,5,5,5,5,5,5,5,5,5,5,5,	5,5,5,5,5,5,5,5,5,5,5,5,5,5,5,5,
0,0,0,0,0,0,0,0,0,0,0,0,0,0,0,0,	5,5,5,5,5,5,5,5,5,5,5,5,5,5,5,5,	5,5,5,5,5,5,5,5,5,5,5,5,5,5,5,5,
0,0,0,0,0,0,0,0,0,0,0,0,0,0,0,0,	5,5,5,5,5,5,5,5,5,5,5,5,5,5,5,5,	5,5,5,5,5,5,5,5,5,5,5,5,5,5,5,5,
0,0,0,0,0,0,0,0,0,0,0,0,0,0,0,0,	5,5,5,5,5,5,5,5,5,5,5,5,5,5,5,5,	5,5,5,5,5,5,5,5,5,5,5,5,5,5,5,5,
0,0,0,0,0,0,0,0,0,0,0,0,0,0,0,0,	5,5,5,5,5,5,5,5,5,5,5,5,5,5,5,5,	5,5,5,5,5,5,5,5,5,5,5,5,5,5,5,5,
0,0,0,0,0,0,0,0,0,0,0,0,0,0,0,0,	5,5,5,5,5,5,5,5,5,5,5,5,5,5,5,5,	5,5,5,5,5,5,5,5,5,5,5,5,5,5,5,5,
0,0,0,0,0,0,0,0,0,0,0,0,0,0,0,0,	5,5,5,5,5,5,5,5,5,5,5,5,5,5,5,5,	5,5,5,5,5,5,5,5,5,5,5,5,5,5,5,5,
0,0,0,0,0,0,0,40,39,0,0,0,0,0,0,0,	5,5,5,5,5,5,5,5,5,5,5,5,5,5,5,5,	5,5,5,5,5,5,5,5,5,5,5,5,5,5,5,5,
0,0,0,0,0,0,0,40,39,0,0,0,0,0,0,0,	5,5,5,5,5,5,5,5,5,5,5,5,5,5,5,5,	5,5,5,5,5,5,5,5,5,5,5,5,5,5,5,5,
0,0,0,0,0,0,0,40,39,0,0,0,0,0,0,0,	5,5,5,5,5,5,5,5,5,5,5,5,5,5,5,5,	5,5,5,5,5,5,5,5,5,5,5,5,5,5,5,5,
0,0,0,0,0,0,0,40,49,0,0,0,0,0,0,0,	5,5,5,5,5,5,5,5,5,5,5,5,5,5,5,5,	5,5,5,5,5,5,5,5,5,5,5,5,5,5,5,5,
0,0,0,0,0,0,0,40,39,0,0,0,0,0,0,0,	5,5,5,5,5,5,5,5,5,5,5,5,5,5,5,5,	5,5,5,5,5,5,5,5,5,5,5,5,5,5,5,5,